1 1 1 1 1 1 1 1 1 1 1 1 1 1 1 1 1 1 1 
S 0 0 I I I I 0 P2 F 0 H 0 0 0 0 0 0 1 
1 1 1 1 1 1 I 1 1 F 1 1 1 0 1 I 1 0 1 
1 0 0 0 N 0 F 0 F F 0 0 0 0 0 0 F 0 1 
1 H 1 1 1 1 1 1 1 1 1 1 1 1 1 0 1 0 1 
1 N 1 0 0 0 0 0 0 H H 0 0 0 1 0 1 0 1 
1 F 1 0 1 1 1 1 1 1 1 1 1 0 1 0 1 0 1 
1 F 0 0 1 0 0 P1 0 0 0 0 1 0 0 0 1 0 1 
1 1 1 0 1 I 1 1 1 1 1 0 1 1 1 1 1 0 1 
1 I F I 1 F 1 0 0 0 1 0 0 0 0 0 1 0 1 
1 F 1 1 1 I 1 0 1 0 1 1 1 1 1 0 1 0 1 
1 I 1 D1 0 D1 1 0 1 0 0 0 0 0 1 0 0 0 1 
1 F 1 0 1 1 1 0 1 1 1 1 1 0 1 1 1 1 1 
1 1 1 0 0 0 0 0 0 0 0 0 1 0 0 0 0 0 1 
1 F 1 1 1 1 1 0 1 1 1 0 1 1 1 1 1 0 1 
1 I F 0 0 0 0 0 0 I 1 0 0 0 0 H 1 D2 1 
1 1 1 1 1 0 1 1 1 I 1 1 1 1 1 0 1 0 1 
1 0 0 0 0 0 0 0 0 0 N N H N N 0 D2 G 1 
1 1 1 1 1 1 1 1 1 1 1 1 1 1 1 1 1 1 1 
